..::::::::::::::::::::::::::::::::::::::::::::::.:::::::::::::::::::::::::::::..
.!$*******************@*********************%$*@::****%$******@******%$******$!.
.!$.********%*******.:@.*%*************%!.*.**.$****%.*$.***:.%**:.*:!$.***!.$!.
.!$.$!:!!!:!$.:!!!!!!*@.$*:!!!!!!!!!!!!$*.$.*$!!.::.@:*$.@*!!!!!!!!@:!$.$!:!!@!.
.!$.$:.!!$!!$::!!!!!!*@.$*.!!!!!@!!!!!!!:.$::!!!:*%:@:*$:!!%$!!!!!!!:!$.$!:!!@!.
.!$.$::*.$%*%*******::@.$*.!*$!.$.*%***%!.@*******%*&:*@*!.!%.!********.$%***@!.
.!$.$:!$.$!.********::@.$*.**$!.$.%*.!.**.$.:*****!.@:*$.!:!@***********$:.!.$!.
.!$.$!*$.$!:$::::!!@!:@.$*:@:::!@.%*.$.**.$.*%:::%%.@:*$.@:!$:!!!!!!!!!!!:*$.$!.
.::.!**!.$!:$.%!:@!*::@.$*:@.:!*@.%*.$.**.$.*%.$.*%.!.*$.@:!%.:!%$!!!!!!!!*$.$!.
.:%******%::$.$%%%.*%%%.$*:&*%!.$.%*.$.!!.$.*%.@.*@***%*.@:!@*%.!%.*****%::$.$!.
.!$.!*!!!!!*$.%!.!!@!.!!@!:@.%*:$.*%!@!!!!@.*%.@!%%.!!!:.@:!%.$:!%.$!:!.$**$.$!.
.!$.$*!!!!!!:.$*:!!$!:@!!:!@.%*:@::!!!!!!!!:%%:!!!::!!%$.@:!%.$:!$.$:!$.$*!:.$!.
.!$.$:.****%%.!*%$.%!:@.:***.%*.*************%********$$.@::!.$::!.$:!$.!::%.$!.
.!$.%%*****%$.!*%$.%!:@******$!.*****%**************%.*$.$%***@%*!.$:!@***%$.$!.
.!$.:!!!!!:!$.::!$.$%!!!!!!!!!!!@::::@::!!!!!!!!!!::@:*$!!!!!!!!!!!@:!$:::!$.$!.
.!$.$%**!@::$.$!:!.!**@!!****!!*!.%*.$.*$!!!%$!!**:.@:*@************:!$.%!:$.$!.
.!$.$%*!.%!:%*$%*****%@.*%***$!.$*%!.$.!!.%.*%.%*%*.@:*%.!***********%$.$!:$.$!.
.!$.$:.!*@%*!*!!****::@.$*.!.%*:@.:**@*!!*@*%*.@:*%.@:*$.!*****!***!.!$.$!:$.$!.
.!$.$!:!!!::!!!!!!:$!:@.$*:@.%*:$.%%:!!!!!!!!::@::::@:*$:!!%$:!!!!!!:*$.$!!$.$!.
.!$.!****!.:$****!.%!:@.$*:@.%*:$.%*.$*%$*!****@.!$*&:*@*!**!.$****$%*!.!*%$.$!.
.!@****:.**%$******@!:@.$*.$*@*:$.%*.$.**.*.!!.$.!*.@:!*.*****$::!.$:.**%::%.$!.
.!$:!!!!!@!:!!!!!!:$!:@.$%!!:%*:$.%*.$.**.$.*$!@!!:.@!!!!&::!!!.!$.$*!::$*!!!$!.
.!$.$*!!!@!:$!!!*$.%!:@::!*@.%*:$.%*.$.**.$::!!!!!::!!!!!&:!$!!:!$:!!*$.$*!!!@!.
.!$.$::$*%::$.*::$.%!.%**:.*.%*:$.!!.$.**.@******%$******%.!%.!**%*****.$:.**@!.
.!$.$:!$.!**%.%%*$.%%*!****!*$!.@****$.**.$.:***.*%.*****!*%$***********$%*!.$!.
.!$.$:!$.$*!!:!!!!:!!!!!!!!!!!:!@!!!!!:::.$::!!@.*%.@!:!!!!!!!!!!!:$!::::!!:.$!.
.!$.!:!$.$%****!!**!!!!******!!*****!!*$*.$.*$**.*%.@:!@*!!******:.$::%.%%*$.$!.
.!@***%*.$:.*******%%*$******%%******%.**.$.**.!*$%.%.*$.%*********$%%*.$::$.$!.
.!$.!**!.$%******!.$!:@.!::!.%$****::@.**.$.*$*!.*$!!*$$.@*****.:**!**!*@!:$.$!.
.!$.$**$.$*!!!!!*$.%!:@.$*:@::!!!!!::$.**.$.*$!@::!!!!%$:!!!!!@!:!!!!!!!$!:$.$!.
.!$.$::!.$!:$*$::$.%!:@.$*:&******$!.$.**.$.:!.$:!$**.:%***%%.********!.$!:!.$!.
.!$.$:.**@!:$.%!:%.%!:$.$*:@.!%**.%*.$.**.$****$.*@********%$***********@!:%*@!.
.!$.$*!!!@!:$.$*!!!$%!:.$*:@.%*:@.%*.$.*%!!!!!!!.*%:!!!!!!!!!!!!!!!!!!!:$!:$:$!.
.!$.!!!!!!:!$.$%!!!!!*@.$*:@.%*.$.%*.$.*$!!!!!!@.*%.!!%$!!!!!!!!!!!@*!:.$!:$.$!.
.!$.*%***$%%*.%!:*.*::@.$*:@.%*:$.%*.$.**.!****%.!%*$.*%.%..**$****%::*.$!:$.$!.
.!$.$!:!.$!.!!$!:$.$!:@.$*:@.%*:$.%*.$.**.!!**!!!*:.@:*@!@*!:.$::*!!!%$.$!:$.$!.
.!$.$:!$.$!:!!!:!$.%!:@.$*:@.%*:$.%*.$.*%:!!%$:!:%%.@:*$:!!!:.$:!$:!:*$.$!:$.$!.
.!$.$:!$.!**!****!.%!:@.$*:@.!::@.!:.$.:*****:.$.*%.@:*$.$*%%.$:!%.%:!$.$!:$.$!.
.!$.$:!@****%****%*@!:&*$!:@.!%*$****$******%!.@:*%.@:*$.@:!*.$:!%.$:!$.$!:$.$!.
.!$.$:!$:::!$:::!$:$!:@::!!@.%*:!!!!!!!!!!!:*$!@.*%.@:*$.@*!!!@:!%.$:!$.$!:$.$!.
.!$.$:!$.$!::.$!:!.$!:@.$%!!.%*.@!!!!!!!!!!.:!!!:*%.@:*$.@*!!!!:!$.$!:::$!:$.$!.
.!$.*:!$.*****%****%:.*.$*.!*@*.%****************%%*%.:*.@:.*****%*%****%::*.$!.
.!$***%$****************$%***$%**************************@*******************$!.
..::::::::::::::::::::::::::::::::::::::::::::::::::::::::::::::::::::::::::::..