................................................................................
...........................!....................................................
...........................!:...................................................
..........................:*:...................................................
..........................:%!...................................................
.........:%%%%%%%%%%%%%%%!.:..!%%%%%%%%%%%%%%%%%%%%%%%%%%%%%%%%%%%%%%%:.........
.........:&%!!!!!!!!!!!!&%....*&!!!!!!!!!!!!!!!!!!!!!!!!!!!!!!!!!!!!%&:.........
.........:&!............@%....*&....................................!&:.........
.........:&!...:********&%....*&%*******************************:...!&:.........
.........:&!...*&*******&%....:********************************&*...!&:.........
.........:&!...*&.......@%.....................................&*...!&:.........
.........:&!...*&.....::&%::::::::::::::::::::::::::::::::.....&*...!&:.........
.........:&!...*&....:$$@$$$$$$$$$$$&@$$$$$$$$$$$$$$$$$$@&:....&*...!&:.........
.........:&!...*&...................&%..................!#!....&*...!&:.........
.........:&!...*&...................&%..................!#!....&*...!&:.........
.........:&!...*&....:!:....%$%%%%%%#*.....*$%%%%%$%....!#!....&*...!&:.........
.........:&!...*&....!#!....&$!!!!!!&%.....!!!!!!!$&....!#!....&*...!&:.........
.........:&!...*&....!#!....&*......&%............*&....!#!....&*...!&:.........
.........:&!...*&....!#!....@*...%$$&@$$$$$$$@$...*&....!#!....&*...!&:.........
.........:&!...:*....!#!....:....::::::::::::%&...*&....!#!....&*...!&:.........
.........:&!.........!#!.....................*&...*&....!#!....&*...!&:.........
.........:&!.........!#!....::!!!!:..........*&...*&....!#!....&*...!&:.........
.........:&!...!%....!#!....&@$$$$!..........*&...*&....!#!....&*...!&:.........
.........:&!...*&::::!#!::::&*...............*&...*&....!#!....&*...!&:.........
.........:&!...*#$$$$$@$$$$$#*...::::::::::::%&...*&....!#!....&*...!&:.........
.........:&!...*&...........&*...%$$$$$$$$$$$@$...*&....!#!....&*...!&:.........
.........:&!...*&...........&*....................*&....!#!....&*...!&:.........
.........:&!...*&.....:.....&$!!!!!!!!!!!!!!!!!!!!$&....!#!....&*...!&:.........
.........:&!...*&....!#!....%$%%%%%%%%%%%%%%%%%%%%$%....!#!....&*...!&:.........
.........:&!...*&....!#!................................!#!....&*...!&:.........
.........:&!...*&....!#!................................!#!....&*...!&:.........
.........:&!...*&....:&@$$$$$$$$$$$$$$$$$$$$$$$$$$$$$$$$@&:....&*...!&:.........
.........:&!...*&.....::::::::::::::::::::::::::::::::::::.....&*...!&:.........
.........:&!...*&..............................................&*...!&:.........
.........:&!...*&**********************************************&*...!&:.........
.........:&!...:************************************************:...!&:.........
.........:&!........................................................!&:.........
.........:&%!!!!!!!!!!!!!!!!!!!!!!!!!!!!!!!!!!!!!!!!!!!.....:!!!!!!!%&:.........
.........:%%%%%%%%%%%%%%%%%%%%%%%%%%%%%%%%%%%%%%%%%%%%%:.::.!%%%%%%%%%:.........
........................................................:%*.....................
.........................................................!:.....................
.........................................................!:.....................
................................................................................
................................................................................