########################################################
########################################################
##..............##.........##.........##...............S
#######....##...########...##...###...#############...##
#######....##...########...##...###...#############...##
##...##....##........###........###...................##
##...##....#######...###...##################....#######
##...##....#######...###...##################....#######
##...##.........##.........##.........##.........##...##
##...########...#############...###################...##
##...########...#############...###################...##
##.........##..............##...###........##.........##
##...#############...########...###...##...########...##
##...#############...########...###...##...########...##
##...##..............###........###...##..............##
##...##....#############...########...##...##....#######
##...##....#############...########...##...##....#######
##...##.........##...###..............##...##....##...##
##...########...##...########...########...##....##...##
##...########...##...########...########...##....##...##
##.........................................##....##...##
#############...##...########...#############....##...##
#############...##...########...#############....##...##
##..............##...###...##...###...................##
##...########...##...###...##...###...##...#############
##...########...##...###...##...###...##...#############
##...##..............###..............##...##.........##
##...#############...###...########...#######....##...##
##...#############...###...########...#######....##...##
G...............................###..............##...##
########################################################
########################################################
