SSSSSSSSSSSSSSSSSSSSSSSSSSSSSSSSSSSSSSSSSSSSSSSSSSSSSSSSSSSSSSSSSSSSSSSSSSSSSSSS
SS@@@@@@@@@@@@@@@##############&@############################&@#############&&*S
S#$&&&&&&&&&&&&&&S*SSSSSSSSSSS*#&*SSSSSSSSSSSSSSSSSSSSSSSSSS*#&*SSSSSSSSSSS*#&*S
S#$&&&&&&&&&&&&&&SSSSSSSSSSSSSS#&*SSSSSSSSSSSSSSSSSSSSSSSSSSS#&*SSSSSSSSSSSS#&*S
S#$&&&&&&&&&&&&&&SSSSSSSSSSSSSS#&*SSSSSSSSSSSSSSSSSSSSSSSSSSS#&*SSSSSSSSSSSS#&*S
S#$&&&&&&&&&&&&&&SSSSSSSSSSSSSS#&*SSSSSSSSSSSSSSSSSSSSSSSSSSS#&*SSSSSSSSSSSS#&*S
S#$&&&&&&&&&&&&&&SSSSSSSSSSSSSS#&*SSSSSSSSSSSSSSSSSSSSSSSSSSS#&*SSSSSSSSSSSS#&*S
S#$&&&&&&&&&&&&&&SSSSSSSSSSSSSS#&*SSSSSSSSSSSSSSSSSSSSSSSSSSS#&*SSSSSSSSSSSS#&*S
S#$&&&&&&&&&&&&@&SSSSSSSSSSSSSS#&*SSSSSSSSSSSSSSSSSSSSSSSSSSS#&*SSSSSSSSSSSS#&*S
S#@&&&&&&&&&&&&&@&*SSSSSSSSSSSSS#SSSSSSSSSSSSSS#SSSSSSSSSSSSS#&*SSSSSSSSSSSS#&*S
S#&*SSS*********#&*SSSSSSSSSSSSSSSSSSSSSSSSSSS#&*SSSSSSSSSSSS#&*SSSSSSSSSSSS#&*S
S#&*SSSSSSSSSSSS#&*SSSSSSSSSSSSSSSSSSSSSSSSSSS#&*SSSSSSSSSSSS#&*SSSSSSSSSSSS#&*S
S#&*SSSSSSSSSSSS#&*SSSSSSSSSSSSSSSSSSSSSSSSSSS#&*SSSSSSSSSSSS#&*SSSSSSSSSSSS#&*S
S#&*SSSSSSSSSSSS#&*SSSSSSSSSSSSSSSSSSSSSSSSSSS#&*SSSSSSSSSSSS#&*SSSSSSSSSSSS#&*S
S#&*SSSSSSSSSSSS#&*SSSSSSSSSSSSSSSSSSSSSSSSSSS#&*SSSSSSSSSSSS#&*SSSSSSSSSSSS#&*S
S#&*SSSSSSSSSSSS#&*SSSSSSSSSSSSSSSSSSSSSSSSSSS#&*SSSSSSSSSSSS#&*SSSSSSSSSSSS#&*S
S#&*SSSSSSSSSSSS#&*SSSSSSSSSSSSSSSSSSSSSSSSSSS#&*SSSSSSSSSSSS#&*SSSSSSSSSSSS#&*S
S#&*SSSSSSSSSSSSS&############################&&*SSSSSSSSSSSSS#SSSSSSSSSSSSS#&*S
S#&*SSSSSSSSSSSSSSSSSSSSSSSSSSSSSSSSSSSSSSSSSS#&*SSSSSSSSSSSSSSSSSSSSSSSSSSS#&*S
S#&*SSSSSSSSSSSSSSSSSSSSSSSSSSSSSSSSSSSSSSSSSS#&SSSSSSSSSSSSSSSSSSSSSSSSSSSS#&*S
S#&*SSSSSSSSSSSSSSSSSSSSSSSSSSSSSSSSSSSSSSSSSS#&SSSSSSSSSSSSSSSSSSSSSSSSSSSS#&*S
S#&*SSSSSSSSSSSSSSSSSSSSSSSSSSSSSSSSSSSSSSSSSS#&SSSSSSSSSSSSSSSSSSSSSSSSSSSS#&*S
S#&*SSSSSSSSSSSSSSSSSSSSSSSSSSSSSSSSSSSSSSSSSS#&SSSSSSSSSSSSSSSSSSSSSSSSSSSS#&*S
S#&*SSSSSSSSSSSSSSSSSSSSSSSSSSSSSSSSSSSSSSSSSS#&SSSSSSSSSSSSSSSSSSSSSSSSSSSS#&*S
S#&*SSSSSSSSSSSSSSSSSSSSSSSSSSSSSSSSSSSSSSSSSS#&*SSSSSSSSSSSSSSSSSSSSSSSSSSS#&*S
S#&*SSSSSSSSSSSSS################SSSSSSSSSSSSSS&###############SSSSSSSSSSSSS#&*S
S#&*SSSSSSSSSSSSSSSSSSSSSSSSSSS#&*SSSSSSSSSSSSSSSSSSSSSSSSSSS#&*SSSSSSSSSSSS#&*S
S#&*SSSSSSSSSSSSSSSSSSSSSSSSSS*#&*SSSSSSSSSSSSSSSSSSSSSSSSSS*#&*SSSSSSSSSSSS#&*S
S#&*SSSSSSSSSSSSSSSSSSSSSSSSSSS#&*SSSSSSSSSSSSSSSSSSSSSSSSSSS#&*SSSSSSSSSSSS#&*S
S#&*SSSSSSSSSSSSSSSSSSSSSSSSSSS#&*SSSSSSSSSSSSSSSSSSSSSSSSSSS#&*SSSSSSSSSSSS#&*S
S#&*SSSSSSSSSSSSSSSSSSSSSSSSSSS#&*SSSSSSSSSSSSSSSSSSSSSSSSSSS#&*SSSSSSSSSSSS#&*S
S#&*SSSSSSSSSSSSSSSSSSSSSSSSSSS#&*SSSSSSSSSSSSSSSSSSSSSSSSSSS#&*SSSSSSSSSSSS#&*S
S#&*SSSSSSSSSSSSSSSSSSSSSSSSSSS#&*SSSSSSSSSSSSSSSSSSSSSSSSSS*#&*SSSSSSSSSSSS#&*S
S#&*SSSSSSSSSSSSSSSSSSSSSSSSSSSS@############################&&*SSSSSSSSSSSS#&*S
S#&*SSSSSSSSSSSS#&*SSSSSSSSSSSSSSSSSSSSSSSSSSSSSSSSSSSSSSSSSSSSSSSSSSSSSSSSS#&*S
S#&*SSSSSSSSSSSS#&*SSSSSSSSSSSSSSSSSSSSSSSSSSSSSSSSSSSSSSSSSSSSSSSSSSSSSSSSS#&*S
S#&*SSSSSSSSSSSS#&*SSSSSSSSSSSSSSSSSSSSSSSSSSSSSSSSSSSSSSSSSSSSSSSSSSSSSSSSS#&*S
S#&*SSSSSSSSSSSS#&*SSSSSSSSSSSSSSSSSSSSSSSSSSSSSSSSSSSSSSSSSSSSSSSSSSSSSSSSS#&*S
S#&*SSSSSSSSSSSS#&*SSSSSSSSSSSSSSSSSSSSSSSSSSSSSSSSSSSSSSSSSSSSSSSSSSSSSSSSS#&*S
S#&*SSSSSSSSSSSS#&*SSSSSSSSSSSSSSSSSSSSSSSSSSSSSSSSSSSSSSSSSSSSSSSSSSSSSSSSS#&*S
S#&*SSSSSSSSSSS*#&*SSSSSSSSSSSSSSSSSSSSSSSSSSSSSSSSSSSSSSSSSSSSSSSSSSSSSSSS*#&*S
SS&##############@S########################################################S#&*S
SSS#SSSSSSSSSS####SSSSSSSSSSSSSSSSSSSSSSSSSSSSSSSSSSSSSSSSSSSSSSSSSSSSSSSS###SSS