.........########################################################.........
.........########################################################.##......
.........##..............##.........##.........##................#########
.........#######....##...########...##...###...#############...##..#......
.........########...##...########...##...###...#############...##.........
.........##...###...##........###........###...................##.........
.........##...###...#######...###...##################....#######.........
.........##...###...#######...###...##################....#######.........
.........##...##.........##.........##.........##.........##...##.........
.........##...########...#############...###################...##.........
.........##...########...#############...###################...##.........
.........##.........##..............##...###........##.........##.........
.........##...#############...########...###...##...########...##.........
.........##...#############...########...###...##...########...##.........
.........##...##..............###........###...##..............##.........
.........##...###...#############...########...##...##....#######.........
.........##...###...#############...########...##...##....#######.........
.........##...##.........##...###..............##...##....##...##.........
.........##...########...##...########...########...##....##...##.........
.........##...########...##...########...########...##....##...##.........
.........##.........................................##....##...##.........
.........#############...##...########...#############....##...##.........
.........#############...##...########...#############....##...##.........
.........##..............##...###...##...###...................##.........
.........##...########...##...###...##...###...##...#############.........
.........##...########...##...###...##...###...##...#############.........
.........##...##..............###..............##...##.........##.........
.........##...#############...###...########...#######....##...##.........
.....##..##...#############...###...########...#######....##...##.........
#########................................###..............##...##.........
.....##..########################################################.........
.........########################################################.........
