........########################################################
........########################################################
........##..............##.........##.........##................
........#######....##...########...##...###...#############...##
........#######....##...########...##...###...#############...##
........##...##....##........###........###...................##
........##...##....#######...###...##################....#######
........##...##....#######...###...##################....#######
........##...##.........##.........##.........##.........##...##
........##...########...#############...###################...##
........##...########...#############...###################...##
........##.........##..............##...###........##.........##
........##...#############...########...###...##...########...##
........##...#############...########...###...##...########...##
........##...##..............###........###...##..............##
........##...##....#############...########...##...##....#######
........##...##....#############...########...##...##....#######
........##...##.........##...###..............##...##....##...##
........##...########...##...########...########...##....##...##
........##...########...##...########...########...##....##...##
........##.........................................##....##...##
........#############...##...########...#############....##...##
........#############...##...########...#############....##...##
........##..............##...###...##...###...................##
........##...########...##...###...##...###...##...#############
........##...########...##...###...##...###...##...#############
........##...##..............###..............##...##.........##
........##...#############...###...########...#######....##...##
....##..##...#############...###...########...#######....##...##
########................................###..............##...##
....##..########################################################
........########################################################
