#######################################################
#######################################################
##..............##.........##.........##..............G
#######....##...########...##...###...#############...#
#######....##...########...##...###...#############...#
##...##....##........###........###...................#
##...##....#######...###...##################....######
##...##....#######...###...##################....######
##...##.........##.........##.........##.........##...#
##...########...#############...###################...#
##...########...#############...###################...#
##.........##..............##...###........##.........#
##...#############...########...###...##...########...#
##...#############...########...###...##...########...#
##...##..............###........###...##..............#
##...##....#############...########...##...##....######
##...##....#############...########...##...##....######
##...##.........##...###..............##...##....##...#
##...########...##...########...########...##....##...#
##...########...##...########...########...##....##...#
##.........................................##....##...#
#############...##...########...#############....##...#
#############...##...########...#############....##...#
##..............##...###...##...###...................#
##...########...##...###...##...###...##...############
##...########...##...###...##...###...##...############
##...##..............###..............##...##.........#
##...#############...###...########...#######....##...#
##...#############...###...########...#######....##...#
S...............................###..............##...#
#######################################################
#######################################################
