#################....#########################################
#################....#########################################
###............##....##....................................###
###...###########....###################################...###
###...###########....###################################...###
###...##.......##.....................................##...###
###...##.....####################################.....##...###
###...##....######################################....##...###
###...##...................##..................###....##...###
###...##...................##..................###....##...###
###...##....###....##########.....#########....###....##...###
###...##....###....##########.....#########....###....##...###
###...##....###....##......##............##....###....##...###
###...##....###....##...##############...##....###....##...###
###...##....###....#....##############...##....###....##...###
###.........###.....................##...##....###....##...###
###.........###....#######..........##...##....###....##...###
###...##....###....#######..........##...##....###....##...###
###...###############...............##...##....###....##...###
###...###############...##############...##....###....##...###
###...##...........##...##############...##....###....##...###
###...##...........##....................##....###....##...###
###...##.....#.....########################....###....##...###
###...##....###....########################....###....##...###
###...##....###................................###....##...###
###...##....###................................###....##...###
###...##....######################################....##...###
###...##.....####################################.....##...###
###...##..............................................##...###
###...##################################################...###
###...##################################################...###
###........................................................###
##############################################.....###########
###############################################....###########
................................................##............
...............................................###............
................................................##............
................................................##............
................................................##............
