##################S###########################################
#################.xxx#########################################
###............##...x##....................................###
###...###########...x###################################...###
###...###########...x###################################...###
###...##.......##...xxxxxxxxxxxxxxxxxxxxxxxxxxxxxx....##...###
###...##.....####################################xx...##...###
###...##....######################################x...##...###
###...##...................##..................###x...##...###
###...##...xxxxxxxx........##....xxxxxxxxxxx...###x...##...###
###...##...x###...x##########....x#########x...###x...##...###
###...##...x###...x##########....x#########x...###x...##...###
###...##...x###...x##......##....xxxxxx..##x...###x...##...###
###...##...x###...x##...##############x..##x...###x...##...###
###...##...x###...x#....##############x..##x...###x...##...###
###........x###...xxxxxxxxx.........##x..##x...###x...##...###
###..xxxxxxx###....#######x.........##x..##x...###x...##...###
###..x##....###....#######x.........##x..##x...###x...##...###
###..x###############..xxxx.........##x..##x...###x...##...###
###..x###############..x##############x..##x...###x...##...###
###..x##...........##..x##############x..##x...###x...##...###
###..x##....xxxxxxx##..xxxxxxxxxxxxxxxx..##x...###x...##...###
###..x##...xx#....x########################x...###x...##...###
###..x##...x###...x########################x...###x...##...###
###..x##...x###...xxxxxxxxxxxxxxxxxxxxxxxxxx...###x...##...###
###..x##...x###................................###x...##...###
###..x##...x######################################x...##...###
###..x##...xx####################################xx...##...###
###..x##....xxxxxxxxxxxxxxxxxxxxxxxxxxxxxxxxxxxxxx....##...###
###..x##################################################...###
###..x##################################################...###
###..xxxxxxxxxxxxxxxxxxxxxxxxxxxxxxxxxxxxxxxxxxx...........###
##############################################.x...###########
###############################################G##############
