###################################S######################################
#..........#...................................##.........##.............#
#...########...#...########...##############...##..####.......#####..#...#
##.....##.....##.........##.........##..#......##..#..........#..##..#...#
####.......############..########...##......####...#..#########......#...#
#..........#...#......#..##.........##.....##......##.##......#......##.##
#...########...#..##.....##..###############...##..#####..##.....#########
####........####..####.####..#...............######...##..####.####......#
################..####.####.......##################..##..########...#...#
##.....##......#####.....#########..##......#......#..##..##......####...#
####...##..#...####...#...###########...#...#..#####..##......########...#
#...#####..#...#...######....#...#....###...#..##...####....###......#...#
#...#..#...#......##.........##..#......#...#.........##.....##..........#
#...#...############...###...##..####...#...#...###...##......########...#
#...#..####.######.......##......####...#...#..####...##..##..###........#
#...#..##..........###############...####...#####..#####..#####...########
#..........#...#..##.........##.........#...#......##.....##.....##.....##
############...#..##..####...#...####...#####...####...#####..########...#
##.............#......#......#...#.................#..##......#......#...#
#...###################...########...####...########..############...#...#
#...#.................#..........#......#......##.....##.........##..#...#
#...###############...########...############..##...####...####..##..#...#
#......##.........##..#......#..........##.##..##.....##..##.............#
####...##..#####..##..#...###########...#...#..#########..##..########...#
##.....##..#..##..##.....##......#......#...#.............##..#..........#
#...#####..#...#..#####..##..#...#...####...################..############
#..........#...#..##.........##..#..........#......#......##.............#
####.......#...#..#####...###############...####...#...#..########...#...#
##.....##......#......#..##.........##.............#..##......#......#...#
###################...#..##..#...#####..#####..#####..##..#...#...#..#...#
##....................#......##.........#..##..##.....##..##.....##..#...#
#...####...################..#########..#...#..##..###################...#
#......##..#.............##.........##......#..##.........##.............#
#####..#####...########..#########..#########..########...##..############
#......##.............#..##......#......#..........#......##..#..........#
#...#..##..####...#...#..##..#...########...####...#...########...#..#...#
#...#..##..#......##..#......##.........#...#.........##......#..##..#...#
#...#..#####...#####..################..#...############..#...#####..#...#
#...#.........##....................##..#.................##.........#...#
######################################G###################################