#################G############################################
#################xxxx#########################################
###............##...x##....................................###
###...###########...x###################################...###
###...###########...x###################################...###
###...##.......##...xxxxxxxxxxxxxxxxxxxxxxxxxxxxxxx...##...###
###...##.....####################################.x...##...###
###...##....######################################x...##...###
###...##...................##..................###x...##...###
###...##xxxxxxxxxxx........##....xxxxxxxxxxx...###x...##...###
###...##x...###...x##########....x#########x...###x...##...###
###...##x...###...x##########....x#########x...###x...##...###
###...##x...###...x##......##....xxxxxx..##x...###x...##...###
###...##x...###...x##...##############x..##x...###x...##...###
###...##x...###...x#....##############x..##x...###x...##...###
###..xxxx...###...xxxxxxxxx.........##x..##x...###x...##...###
###..x......###....#######x.........##x..##x...###x...##...###
###..x##....###....#######x.........##x..##x...###x...##...###
###..x###############..xxxx.........##x..##x...###x...##...###
###..x###############..x##############x..##x...###x...##...###
###..x##...........##..x##############x..##x...###x...##...###
###..x##...xxxxxxxx##..xxxxxxxxxxxxxxxx..##x...###x...##...###
###..x##...x.#....x########################x...###x...##...###
###..x##...x###...x########################x...###x...##...###
###..x##...x###...xxxxxxxxxxxxxxxxxxxxxxxxxx...###x...##...###
###..x##...x###................................###x...##...###
###..x##...x######################################x...##...###
###..x##...xx####################################xx...##...###
###..x##....xxxxxxxxxxxxxxxxxxxxxxxxxxxxxxxxxxxxxx....##...###
###..x##################################################...###
###..x##################################################...###
###..xxxxxxxxxxxxxxxxxxxxxxxxxxxxxxxxxxxxxxxxxxxx..........###
##############################################..x..###########
################################################S#############
