##################################G######################################
##.###.....##..###..#####..##...##..#.....##..########.#..#.########....#
##.#.#..#.#.#..#.##..#..##........#...##...##...#....#.#..#......#...##.#
##...#.##.#....#......#...........#.#....#......#.##.#...##......#...##.#
######.##...#..#.###..##.#####.###..#..#.####..##.##.#####...###.##...#.#
###..#..########.######.#####..##.###.##.#....#.#.##.#..###############.#
##...#..############..#.#..#.###..#..###.######.#..########...##.#..###.#
##.#...##.....##......#.##...#...##...##...##...#......#....#.##........#
##.#......#......#....#.##...#....#...##.#....#......#....#...##........#
##.#.######.######.#..#.#..#.#.#########.###.##..###.#####..#############
##.#.#..#####..#.#.##.#.#..###.##..##..#####..#######..###..#..########.#
##...#..#...#..#...##...#..#...##...#....#...##......#......#.##.#....#.#
##.....##...##.....##.....##......#.#.##........#....#......#.##...#....#
##...###..#.##...#.##.#...##...#..#..###...##...#...##......#..###.##...#
##.#.#..###....#.#....###..###.##.########.#...##....#####..#..###.###..#
##.#.###..#############.#..#.#.###########.##########..#..##########....#
##.#......#......#....#........##.............#........#..#........#..#.#
##.#...##.#...##...##.#...##...#..#...##......#...##......#.#......#..#.#
##.#####..###..######.###..#.######..##########.#.##.#..#####..#####..###
####.######.####.#..##..#..#.###..#.#############.##.#####..#######.....#
##.#..##..#....#.##.##..####...##...#....#..##..#.##...#..#..##..#...##.#
##.#...##...#..#......#........##.#...##.#.####......#...##...##.#.##...#
##.#.#....#....#...##.#.......####..#.#..#.#..#..###.##..#....##...#..###
##.#.###..####################.##.#.#..###.#####..###..#..###..#####..#.#
##.#...####..#######..##.....#.#..#.#.#..##...#..#########..#..########.#
#####################################S###################################